Photo for Rolando AaronsRolando Aarons	Midfielder	England
Photo for Tammy AbrahamTammy Abraham	Forward	England
Photo for AdriánAdrián	Goalkeeper	Spain
Photo for Adrien SilvaAdrien Silva	Midfielder	Portugal
Photo for Benik AfobeBenik Afobe	Forward	The Democratic Republic Of Congo
Photo for Sergio AgüeroSergio Agüero	Forward	Argentina
Photo for Daniel AgyeiDaniel Agyei	Forward	England
Photo for Soufyan AhannachSoufyan Ahannach	Midfielder	Netherlands
Photo for Nathan AkéNathan Aké	Defender	Netherlands
Photo for Chuba AkpomChuba Akpom	Forward	England
Photo for Marc AlbrightonMarc Albrighton	Midfielder	England
Photo for Toby AlderweireldToby Alderweireld	Defender	Belgium
Photo for Aleix GarcíaAleix García	Midfielder	Spain
Photo for Trent Alexander-ArnoldTrent Alexander-Arnold	Defender	England
Photo for Alexis Mac AllisterAlexis Mac Allister	Midfielder	Argentina
Photo for Ali KoikiAli Koiki	Defender	England
Photo for AlissonAlisson	Goalkeeper	Brazil
Photo for Allan SouzaAllan Souza	Midfielder	Brazil
Photo for Miguel AlmirónMiguel Almirón	Midfielder	Paraguay
Photo for Marcos AlonsoMarcos Alonso	Defender	Spain
Photo for Paulo AlvesPaulo Alves	Midfielder	Portugal
Photo for Daniel AmarteyDaniel Amartey	Midfielder	Ghana
Photo for Luke AmosLuke Amos	Midfielder	England
Photo for Ethan AmpaduEthan Ampadu	Defender	Wales
Photo for Nordin AmrabatNordin Amrabat	Forward	Morocco
Photo for Tom AndersonTom Anderson	Defender	England
Photo for Florin AndoneFlorin Andone	Forward	Romania
Photo for André GomesAndré Gomes	Midfielder	Portugal
Photo for Andreas PereiraAndreas Pereira	Midfielder	Brazil
Photo for Michail AntonioMichail Antonio	Midfielder	England
Photo for Antonio ValenciaAntonio Valencia	Defender	Ecuador
Photo for Billy ArceBilly Arce	Midfielder	Ecuador
Photo for Adam ArmstrongAdam Armstrong	Forward	England
Photo for Marko ArnautovicMarko Arnautovic	Forward	Austria
Photo for Kepa ArrizabalagaKepa Arrizabalaga	Goalkeeper	Spain
Photo for Harry ArterHarry Arter	Midfielder	Ireland
Photo for Daniel ArzaniDaniel Arzani	Midfielder	Australia
Photo for Taye Ashby-HammondTaye Ashby-Hammond	Goalkeeper	England
Photo for Christian AtsuChristian Atsu	Midfielder	Ghana
Photo for Pierre-Emerick AubameyangPierre-Emerick Aubameyang	Forward	Gabon
Photo for Serge AurierSerge Aurier	Defender	Cote D'Ivoire
Photo for Charlie AustinCharlie Austin	Forward	England
Photo for Taiwo AwoniyiTaiwo Awoniyi	Forward	Nigeria
Photo for Jordan AyewJordan Ayew	Forward	Ghana
Photo for Floyd AyitéFloyd Ayité	Forward	Togo
Photo for Ayoze PérezAyoze Pérez	Forward	Spain
Photo for César AzpilicuetaCésar Azpilicueta	Defender	Spain
Photo for Abdul Rahman BabaAbdul Rahman Baba	Defender	Ghana
Photo for Ryan BabelRyan Babel	Midfielder	Netherlands
Photo for Daniel BachmannDaniel Bachmann	Goalkeeper	Austria
Photo for Leandro BacunaLeandro Bacuna	Midfielder	Curacao
Photo for Eric BaillyEric Bailly	Defender	Cote D'Ivoire
Photo for Leighton BainesLeighton Baines	Defender	England
Photo for Tiemoué BakayokoTiemoué Bakayoko	Midfielder	France
Photo for Lewis BakerLewis Baker	Midfielder	England
Photo for Fabián BalbuenaFabián Balbuena	Defender	Paraguay
Photo for Sam BaldockSam Baldock	Forward	England
Photo for Leon BalogunLeon Balogun	Defender	Nigeria
Photo for Tudor BalutaTudor Baluta	Defender	Romania
Photo for Beni BaningimeBeni Baningime	Midfielder	The Democratic Republic Of Congo
Photo for Ben BarclayBen Barclay	Defender	England
Photo for Phil BardsleyPhil Bardsley	Defender	Scotland
Photo for Ross BarkleyRoss Barkley	Midfielder	England
Photo for Daniel BarlaserDaniel Barlaser	Midfielder	England
Photo for Ashley BarnesAshley Barnes	Forward	Austria
Photo for Antonio BarrecaAntonio Barreca	Defender	Italy
Photo for Connor BarrettConnor Barrett	Midfielder	England
Photo for Michy BatshuayiMichy Batshuayi	Forward	Belgium
Photo for Danny BatthDanny Batth	Defender	England
Photo for Jan BednarekJan Bednarek	Defender	Poland
Photo for Asmir BegovicAsmir Begovic	Goalkeeper	Bosnia And Herzegovina
Photo for Héctor BellerínHéctor Bellerín	Defender	Spain
Photo for Yohan BenalouaneYohan Benalouane	Defender	Tunisia
Photo for Filip BenkovicFilip Benkovic	Defender	Croatia
Photo for Joe BennettJoe Bennett	Defender	England
Photo for Benny Ashley-SealBenny Ashley-Seal	Forward	England
Photo for Josh BensonJosh Benson	Midfielder	England
Photo for Christian BentekeChristian Benteke	Forward	Belgium
Photo for Adrián BernabéAdrián Bernabé	Midfielder	Spain
Photo for BernardBernard	Midfielder	Brazil
Photo for BernardoBernardo	Defender	Brazil
Photo for Bernardo SilvaBernardo Silva	Midfielder	Portugal
Photo for Ryan BertrandRyan Bertrand	Defender	England
Photo for Muhamed BesicMuhamed Besic	Midfielder	Bosnia And Herzegovina
Photo for Marcus BettinelliMarcus Bettinelli	Goalkeeper	England
Photo for Philip BillingPhilip Billing	Midfielder	Denmark
Photo for Yves BissoumaYves Bissouma	Midfielder	Mali
Photo for Daley BlindDaley Blind	Defender	Netherlands
Photo for Jeremie BogaJeremie Boga	Midfielder	Cote D'Ivoire
Photo for Adam BogdanAdam Bogdan	Goalkeeper	Hungary
Photo for Omar BogleOmar Bogle	Forward	England
Photo for Joshua BohuiJoshua Bohui	Forward	England
Photo for Yannick BolasieYannick Bolasie	Forward	The Democratic Republic Of Congo
Photo for Luke BoltonLuke Bolton	Midfielder	England
Photo for Willy BolyWilly Boly	Defender	France
Photo for Gaëtan BongGaëtan Bong	Defender	Cameroon
Photo for Artur BorucArtur Boruc	Goalkeeper	Poland
Photo for Sofiane BoufalSofiane Boufal	Midfielder	Morocco
Photo for Jamie BowdenJamie Bowden	Midfielder	England
Photo for Robbie BradyRobbie Brady	Midfielder	Ireland
Photo for Claudio BravoClaudio Bravo	Goalkeeper	Chile
Photo for Rhian BrewsterRhian Brewster	Forward	England
Photo for Brian MurphyBrian Murphy	Goalkeeper	Ireland
Photo for Miguel BritosMiguel Britos	Defender	Uruguay
Photo for Nathan BroadheadNathan Broadhead	Midfielder	Wales
Photo for David BrooksDavid Brooks	Midfielder	Wales
Photo for Ciaron BrownCiaron Brown	Defender	England
Photo for Marcus BrowneMarcus Browne	Midfielder	England
Photo for Tyias BrowningTyias Browning	Defender	England
Photo for BrunoBruno	Defender	Spain
Photo for Joe BryanJoe Bryan	Defender	England
Photo for Craig BrysonCraig Bryson	Midfielder	Scotland
Photo for Marcin BulkaMarcin Bulka	Goalkeeper	Poland
Photo for Harry BurgoyneHarry Burgoyne	Goalkeeper	England
Photo for Reece BurkeReece Burke	Defender	England
Photo for Dan BurnDan Burn	Defender	England
Photo for Matt ButcherMatt Butcher	Defender	England
Photo for David ButtonDavid Button	Goalkeeper	England
Photo for Oskar BuurOskar Buur	Defender	Denmark
Photo for Sam ByramSam Byram	Defender	England
Photo for Willy CaballeroWilly Caballero	Goalkeeper	Argentina
Photo for Yohan CabayeYohan Cabaye	Midfielder	France
Photo for Gary CahillGary Cahill	Defender	England
Photo for Tom CairneyTom Cairney	Midfielder	Scotland
Photo for Dominic Calvert-LewinDominic Calvert-Lewin	Forward	England
Photo for Rafael CamachoRafael Camacho	Midfielder	Portugal
Photo for Víctor CamarasaVíctor Camarasa	Midfielder	Spain
Photo for Lee CampLee Camp	Goalkeeper	Northern Ireland
Photo for Joel CampbellJoel Campbell	Forward	Costa Rica
Photo for Emre CanEmre Can	Midfielder	Germany
Photo for Etienne CapoueEtienne Capoue	Midfielder	France
Photo for Baily CargillBaily Cargill	Defender	England
Photo for Carlos SánchezCarlos Sánchez	Midfielder	Colombia
Photo for Michael CarrickMichael Carrick	Midfielder	England
Photo for Guido CarrilloGuido Carrillo	Forward	Argentina
Photo for Andy CarrollAndy Carroll	Forward	England
Photo for Cameron Carter-VickersCameron Carter-Vickers	Defender	United States
Photo for Lewis CassLewis Cass	Defender	England
Photo for Craig CathcartCraig Cathcart	Defender	Northern Ireland
Photo for Ivan CavaleiroIvan Cavaleiro	Forward	Portugal
Photo for Petr CechPetr Cech	Goalkeeper	Czech Republic
Photo for Cédric SoaresCédric Soares	Defender	Portugal
Photo for Trevoh ChalobahTrevoh Chalobah	Midfielder	England
Photo for Calum ChambersCalum Chambers	Defender	England
Photo for Charly MusondaCharly Musonda	Midfielder	Belgium
Photo for ChicharitoChicharito	Forward	Mexico
Photo for Ben ChilwellBen Chilwell	Defender	England
Photo for Pedro ChirivellaPedro Chirivella	Midfielder	Spain
Photo for Tahith ChongTahith Chong	Midfielder	Netherlands
Photo for Hamza ChoudhuryHamza Choudhury	Midfielder	England
Photo for Andreas ChristensenAndreas Christensen	Defender	Denmark
Photo for Cyrus ChristieCyrus Christie	Defender	Ireland
Photo for Isaac Christie-DaviesIsaac Christie-Davies	Midfielder	England
Photo for Ibrahima CisséIbrahima Cissé	Midfielder	Guinea
Photo for Ciaran ClarkCiaran Clark	Defender	Ireland
Photo for Jordy ClasieJordy Clasie	Midfielder	Netherlands
Photo for Tom CleverleyTom Cleverley	Midfielder	England
Photo for Nathaniel ClyneNathaniel Clyne	Defender	England
Photo for Conor CoadyConor Coady	Midfielder	England
Photo for Jack ColbackJack Colback	Midfielder	England
Photo for Seamus ColemanSeamus Coleman	Defender	Ireland
Photo for Will CollarWill Collar	Midfielder	England
Photo for Bradley CollinsBradley Collins	Goalkeeper	England
Photo for Aaron ConnollyAaron Connolly	Forward	Ireland
Photo for Jack CorkJack Cork	Midfielder	England
Photo for Thibaut CourtoisThibaut Courtois	Goalkeeper	Belgium
Photo for Conor CoventryConor Coventry	Midfielder	England
Photo for Cameron CoxeCameron Coxe	Defender	Wales
Photo for Aaron CresswellAaron Cresswell	Defender	England
Photo for Peter CrouchPeter Crouch	Forward	England
Photo for Cristián CuevasCristián Cuevas	Defender	Chile
Photo for Josh CullenJosh Cullen	Midfielder	Ireland
Photo for Jamie CummingJamie Cumming	Goalkeeper	England
Photo for Greg CunninghamGreg Cunningham	Defender	Ireland
Photo for Pontus DahlbergPontus Dahlberg	Goalkeeper	Sweden
Photo for James DalyJames Daly	Forward	England
Photo for Loïc DamourLoïc Damour	Midfielder	France
Photo for Charlie DanielsCharlie Daniels	Defender	England
Photo for DaniloDanilo	Defender	Brazil
Photo for Scott DannScott Dann	Defender	England
Photo for Danny IngsDanny Ings	Forward	England
Photo for Karl DarlowKarl Darlow	Goalkeeper	England
Photo for Matteo DarmianMatteo Darmian	Defender	Italy
Photo for David LuizDavid Luiz	Defender	Brazil
Photo for Tom DaviesTom Davies	Midfielder	England
Photo for Steven DavisSteven Davis	Midfielder	Northern Ireland
Photo for Kevin De BruyneKevin De Bruyne	Midfielder	Belgium
Photo for Bobby De Cordova-ReidBobby De Cordova-Reid	Midfielder	England
Photo for David de GeaDavid de Gea	Goalkeeper	Spain
Photo for Luca De La TorreLuca De La Torre	Midfielder	United States
Photo for Troy DeeneyTroy Deeney	Forward	England
Photo for Jermain DefoeJermain Defoe	Forward	England
Photo for Steven DefourSteven Defour	Midfielder	Belgium
Photo for Damien DelaneyDamien Delaney	Defender	Ireland
Photo for Dele AlliDele Alli	Midfielder	England
Photo for Fabian DelphFabian Delph	Midfielder	England
Photo for Mousa DembéléMousa Dembélé	Midfielder	Belgium
Photo for Jason DenayerJason Denayer	Defender	Belgium
Photo for Leander DendonckerLeander Dendoncker	Midfielder	Belgium
Photo for Denis SuárezDenis Suárez	Midfielder	Spain
Photo for Alex DennyAlex Denny	Midfielder	England
Photo for Laurent DepoitreLaurent Depoitre	Forward	Belgium
Photo for Sylvain DeslandesSylvain Deslandes	Defender	France
Photo for Gerard DeulofeuGerard Deulofeu	Forward	Spain
Photo for Fousseni DiabatéFousseni Diabaté	Midfielder	Mali
Photo for Adama DiakhabyAdama Diakhaby	Forward	France
Photo for Mohamed DiaméMohamed Diamé	Midfielder	Senegal
Photo for Grady DianganaGrady Diangana	Midfielder	England
Photo for Brahim DíazBrahim Díaz	Midfielder	Spain
Photo for Diego CavalieriDiego Cavalieri	Goalkeeper	Brazil
Photo for Eric DierEric Dier	Midfielder	England
Photo for Lucas DigneLucas Digne	Defender	France
Photo for Diogo DalotDiogo Dalot	Defender	Portugal
Photo for Diogo JotaDiogo Jota	Midfielder	Portugal
Photo for Issa DiopIssa Diop	Defender	France
Photo for Brice Dja DjédjéBrice Dja Djédjé	Defender	Cote D'Ivoire
Photo for Marcelo DjalóMarcelo Djaló	Defender	Guinea-Bissau
Photo for Mihai-Alexandru DobreMihai-Alexandru Dobre	Midfielder	Romania
Photo for Matt DohertyMatt Doherty	Defender	Ireland
Photo for Abdoulaye DoucouréAbdoulaye Doucouré	Midfielder	France
Photo for Barry DouglasBarry Douglas	Defender	Scotland
Photo for Douglas LuizDouglas Luiz	Midfielder	Brazil
Photo for Kieran DowellKieran Dowell	Midfielder	England
Photo for Vlad DragomirVlad Dragomir	Midfielder	Romania
Photo for Aleksandar DragovicAleksandar Dragovic	Defender	Austria
Photo for Luke DreherLuke Dreher	Midfielder	England
Photo for Daniel DrinkwaterDaniel Drinkwater	Midfielder	England
Photo for Anthony Driscoll-GlennonAnthony Driscoll-Glennon	Defender	England
Photo for Martin DubravkaMartin Dubravka	Goalkeeper	Slovakia
Photo for Shane DuffyShane Duffy	Defender	Ireland
Photo for Demeaco DuhaneyDemeaco Duhaney	Defender	England
Photo for Stephen Duke-McKennaStephen Duke-McKenna	Midfielder	England
Photo for Paul DummettPaul Dummett	Defender	Wales
Photo for Lewis DunkLewis Dunk	Defender	England
Photo for Erik DurmErik Durm	Defender	Germany
Photo for Bruno Ecuele MangaBruno Ecuele Manga	Defender	Gabon
Photo for Eddie NketiahEddie Nketiah	Forward	England
Photo for EdersonEderson	Goalkeeper	Brazil
Photo for Rarmani Edmonds-GreenRarmani Edmonds-Green	Defender	England
Photo for EduardoEduardo	Goalkeeper	Portugal
Photo for Callum ElderCallum Elder	Defender	Australia
Photo for Robert ElliotRobert Elliot	Goalkeeper	Ireland
Photo for Harvey ElliottHarvey Elliott	Midfielder	England
Photo for Mohamed ElyounoussiMohamed Elyounoussi	Midfielder	Norway
Photo for EmersonEmerson	Defender	Italy
Photo for Niall EnnisNiall Ennis	Forward	England
Photo for Bright EnobakhareBright Enobakhare	Forward	England
Photo for Christian EriksenChristian Eriksen	Midfielder	Denmark
Photo for Neil EtheridgeNeil Etheridge	Goalkeeper	Philippines
Photo for Jonny EvansJonny Evans	Defender	Northern Ireland
Photo for Patrice EvraPatrice Evra	Defender	France
Photo for Jason Eyenga LokiloJason Eyenga Lokilo	Midfielder	The Democratic Republic Of Congo
Photo for Timothy EyomaTimothy Eyoma	Defender	England
Photo for Lukasz FabianskiLukasz Fabianski	Goalkeeper	Poland
Photo for FabinhoFabinho	Midfielder	Brazil
Photo for Cesc FàbregasCesc Fàbregas	Midfielder	Spain
Photo for FabriFabri	Goalkeeper	Spain
Photo for Adam FedericiAdam Federici	Goalkeeper	Australia
Photo for Federico FernándezFederico Fernández	Defender	Argentina
Photo for Liam FeeneyLiam Feeney	Midfielder	England
Photo for Felipe AndersonFelipe Anderson	Midfielder	Brazil
Photo for Marouane FellainiMarouane Fellaini	Midfielder	Belgium
Photo for Edimilson FernandesEdimilson Fernandes	Midfielder	Switzerland
Photo for FernandinhoFernandinho	Midfielder	Brazil
Photo for Jon FlanaganJon Flanagan	Defender	England
Photo for Jake FlanniganJake Flannigan	Midfielder	England
Photo for Phil FodenPhil Foden	Forward	England
Photo for Michael FoliviMichael Folivi	Forward	England
Photo for Fraser ForsterFraser Forster	Goalkeeper	England
Photo for Marlon FosseyMarlon Fossey	Defender	United States
Photo for Ben FosterBen Foster	Goalkeeper	England
Photo for Timothy Fosu-MensahTimothy Fosu-Mensah	Defender	Netherlands
Photo for Dimitri FoulquierDimitri Foulquier	Defender	Guadeloupe
Photo for Juan FoythJuan Foyth	Defender	Argentina
Photo for Simon FrancisSimon Francis	Defender	England
Photo for Tyrese FrancoisTyrese Francois	Midfielder	Australia
Photo for Ryan FraserRyan Fraser	Midfielder	Scotland
Photo for FredFred	Midfielder	Brazil
Photo for Freddy WoodmanFreddy Woodman	Goalkeeper	England
Photo for Ryan FredericksRyan Fredericks	Defender	England
Photo for Christian FuchsChristian Fuchs	Defender	Austria
Photo for Ramiro Funes MoriRamiro Funes Mori	Defender	Argentina
Photo for Manolo GabbiadiniManolo Gabbiadini	Forward	Italy
Photo for Gabriel JesusGabriel Jesus	Forward	Brazil
Photo for Sam GallagherSam Gallagher	Forward	England
Photo for Brendan GallowayBrendan Galloway	Defender	England
Photo for Luke GarbuttLuke Garbutt	Defender	England
Photo for Eric GarciaEric Garcia	Defender	Spain
Photo for Florin GardosFlorin Gardos	Defender	Romania
Photo for James GarnerJames Garner	Midfielder	England
Photo for Benjamin GarreBenjamin Garre	Midfielder	England
Photo for Dwight GayleDwight Gayle	Forward	England
Photo for Paulo GazzanigaPaulo Gazzaniga	Goalkeeper	Argentina
Photo for Anthony GeorgiouAnthony Georgiou	Midfielder	Cyprus
Photo for Rachid GhezzalRachid Ghezzal	Midfielder	Algeria
Photo for Morgan Gibbs-WhiteMorgan Gibbs-White	Midfielder	England
Photo for Ben GibsonBen Gibson	Defender	England
Photo for Ryan John GilesRyan John Giles	Midfielder	England
Photo for Charlie GilmourCharlie Gilmour	Midfielder	Scotland
Photo for Gio McGregorGio McGregor	Midfielder	England
Photo for Olivier GiroudOlivier Giroud	Forward	France
Photo for Paul GladonPaul Gladon	Forward	Netherlands
Photo for Connor GoldsonConnor Goldson	Defender	England
Photo for Claudio GomesClaudio Gomes	Midfielder	France
Photo for Joseph GomezJoseph Gomez	Defender	England
Photo for Anthony GordonAnthony Gordon	Midfielder	England
Photo for Dan GoslingDan Gosling	Midfielder	England
Photo for Frédéric GounongbeFrédéric Gounongbe	Forward	Benin
Photo for Kamil GrabaraKamil Grabara	Goalkeeper	Poland
Photo for Lewis GrabbanLewis Grabban	Forward	England
Photo for Jordan GrahamJordan Graham	Midfielder	England
Photo for Karlan GrantKarlan Grant	Forward	England
Photo for Demarai GrayDemarai Gray	Midfielder	England
Photo for Robert GreenRobert Green	Goalkeeper	England
Photo for Mason GreenwoodMason Greenwood	Forward	England
Photo for Daniel GrimshawDaniel Grimshaw	Goalkeeper	England
Photo for Pascal GroßPascal Groß	Midfielder	Germany
Photo for Marko GrujicMarko Grujic	Midfielder	Serbia
Photo for Vicente GuaitaVicente Guaita	Goalkeeper	Spain
Photo for Matteo GuendouziMatteo Guendouzi	Midfielder	France
Photo for Idrissa GueyeIdrissa Gueye	Midfielder	Senegal
Photo for Ilkay GündoganIlkay Gündogan	Midfielder	Germany
Photo for Angus GunnAngus Gunn	Goalkeeper	England
Photo for Aron GunnarssonAron Gunnarsson	Midfielder	Iceland
Photo for Viktor GyokeresViktor Gyokeres	Forward	Sweden
Photo for Florent HadergjonajFlorent Hadergjonaj	Defender	Switzerland
Photo for Massadio HaidaraMassadio Haidara	Defender	Mali
Photo for Sead HaksabanovicSead Haksabanovic	Midfielder	Montenegro
Photo for Greg HalfordGreg Halford	Defender	England
Photo for Ben HamerBen Hamer	Goalkeeper	England
Photo for Ethan HamiltonEthan Hamilton	Midfielder	Scotland
Photo for Nathan HarkerNathan Harker	Goalkeeper	England
Photo for Kadeem HarrisKadeem Harris	Midfielder	England
Photo for Jack HarrisonJack Harrison	Midfielder	England
Photo for Joe HartJoe Hart	Goalkeeper	England
Photo for Kortney HauseKortney Hause	Defender	England
Photo for Isaac HaydenIsaac Hayden	Midfielder	England
Photo for Eden HazardEden Hazard	Forward	Belgium
Photo for Rhys HealeyRhys Healey	Forward	England
Photo for Tom HeatonTom Heaton	Goalkeeper	England
Photo for Michael HectorMichael Hector	Defender	Jamaica
Photo for Michael HefeleMichael Hefele	Defender	Germany
Photo for Hélder CostaHélder Costa	Midfielder	Portugal
Photo for Tomer HemedTomer Hemed	Forward	Israel
Photo for Jordan HendersonJordan Henderson	Midfielder	England
Photo for Jeff HendrickJeff Hendrick	Midfielder	Ireland
Photo for Wayne HennesseyWayne Hennessey	Goalkeeper	Wales
Photo for Dion HenryDion Henry	Goalkeeper	England
Photo for Ander HerreraAnder Herrera	Midfielder	Spain
Photo for Jake HeskethJake Hesketh	Midfielder	England
Photo for Heurelho GomesHeurelho Gomes	Goalkeeper	Brazil
Photo for Mateusz HeweltMateusz Hewelt	Goalkeeper	Poland
Photo for Gonzalo HiguaínGonzalo Higuaín	Forward	Argentina
Photo for Jordy Hiwula-MayifuilaJordy Hiwula-Mayifuila	Forward	England
Photo for Tommie HobanTommie Hoban	Defender	Ireland
Photo for Shaun HobsonShaun Hobson	Defender	England
Photo for Wesley HoedtWesley Hoedt	Defender	Netherlands
Photo for Ki-Jana HoeverKi-Jana Hoever	Defender	Netherlands
Photo for Jonathan HoggJonathan Hogg	Midfielder	England
Photo for David Junior HoilettDavid Junior Hoilett	Forward	Canada
Photo for Rob HoldingRob Holding	Defender	England
Photo for José HolebasJosé Holebas	Defender	Greece
Photo for Mason HolgateMason Holgate	Defender	England
Photo for Nathan HollandNathan Holland	Midfielder	England
Photo for Tareiq Holmes-DennisTareiq Holmes-Dennis	Defender	England
Photo for Fraser HornbyFraser Hornby	Midfielder	Scotland
Photo for Callum Hudson-OdoiCallum Hudson-Odoi	Forward	England
Photo for Sam HughesSam Hughes	Defender	England
Photo for Jordan HugillJordan Hugill	Forward	England
Photo for Cameron Humphreys-GrantCameron Humphreys-Grant	Defender	England
Photo for Lloyd HumphriesLloyd Humphries	Midfielder	Wales
Photo for Uwe HünemeierUwe Hünemeier	Defender	Germany
Photo for Des HutchinsonDes Hutchinson	Midfielder	Ireland
Photo for Robert HuthRobert Huth	Defender	Germany
Photo for Emerson HyndmanEmerson Hyndman	Midfielder	United States
Photo for Pierre-Emile HøjbjergPierre-Emile Højbjerg	Midfielder	Denmark
Photo for Jordon IbeJordon Ibe	Midfielder	England
Photo for Vicente IborraVicente Iborra	Midfielder	Spain
Photo for Kelechi IheanachoKelechi Iheanacho	Forward	Nigeria
Photo for Carl IkemeCarl Ikeme	Goalkeeper	Nigeria
Photo for Iker PozoIker Pozo	Midfielder	Spain
Photo for Dejan IlievDejan Iliev	Goalkeeper	North Macedonia	
Photo for Rohan InceRohan Ince	Midfielder	England
Photo for Ryan InnissRyan Inniss	Defender	England
Photo for Isaac SuccessIsaac Success	Forward	Nigeria
Photo for Alex IwobiAlex Iwobi	Midfielder	Nigeria
Photo for José IzquierdoJosé Izquierdo	Forward	Colombia
Photo for Jaroslaw JachJaroslaw Jach	Defender	Poland
Photo for Brad JacksonBrad Jackson	Midfielder	England
Photo for Phil JagielkaPhil Jagielka	Defender	England
Photo for Alireza JahanbakhshAlireza Jahanbakhsh	Forward	Iran
Photo for Eldin JakupovicEldin Jakupovic	Goalkeeper	Switzerland
Photo for Matty JamesMatty James	Midfielder	England
Photo for Daryl JanmaatDaryl Janmaat	Defender	Netherlands
Photo for Vincent JanssenVincent Janssen	Forward	Netherlands
Photo for Jazz RichardsJazz Richards	Defender	Wales
Photo for Carl JenkinsonCarl Jenkinson	Defender	England
Photo for Moritz JenzMoritz Jenz	Defender	Germany
Photo for Jesús GámezJesús Gámez	Defender	Spain
Photo for Raúl JiménezRaúl Jiménez	Forward	Mexico
Photo for João MárioJoão Mário	Midfielder	Portugal
Photo for João MoutinhoJoão Moutinho	Midfielder	Portugal
Photo for João VirgíniaJoão Virgínia	Goalkeeper	Portugal
Photo for Joe PowellJoe Powell	Midfielder	England
Photo for Joe WillockJoe Willock	Midfielder	England
Photo for Joel PereiraJoel Pereira	Goalkeeper	Portugal
Photo for Johann GudmundssonJohann Gudmundsson	Midfielder	Iceland
Photo for Stefan JohansenStefan Johansen	Midfielder	Norway
Photo for Declan JohnDeclan John	Defender	Wales
Photo for Tyreece John-JulesTyreece John-Jules	Forward	England
Photo for Darnell JohnsonDarnell Johnson	Defender	England
Photo for George JohnstonGeorge Johnston	Defender	England
Photo for Sam JohnstoneSam Johnstone	Goalkeeper	England
Photo for Jonathan DinzeyiJonathan Dinzeyi	Defender	England
Photo for Jonathan WilliamsJonathan Williams	Midfielder	Wales
Photo for Curtis JonesCurtis Jones	Midfielder	England
Photo for JonnyJonny	Defender	Spain
Photo for Jordan WilliamsJordan Williams	Defender	England
Photo for JorginhoJorginho	Midfielder	Italy
Photo for JoseluJoselu	Forward	Spain
Photo for Josh Da SilvaJosh Da Silva	Midfielder	England
Photo for Josh MurphyJosh Murphy	Midfielder	England
Photo for Josh SimsJosh Sims	Midfielder	England
Photo for Christian KabaseleChristian Kabasele	Defender	Belgium
Photo for Younes KaboulYounes Kaboul	Defender	France
Photo for Elias KachungaElias Kachunga	Forward	The Democratic Republic Of Congo
Photo for Sullay KaikaiSullay Kaikai	Midfielder	England
Photo for Mattias KaitMattias Kait	Midfielder	Estonia
Photo for Tomas KalasTomas Kalas	Defender	Czech Republic
Photo for Aboubakar KamaraAboubakar Kamara	Forward	France
Photo for Harry KaneHarry Kane	Forward	England
Photo for N'Golo KantéN'Golo Kanté	Midfielder	France
Photo for Bartosz KapustkaBartosz Kapustka	Midfielder	Poland
Photo for Loris KariusLoris Karius	Goalkeeper	Germany
Photo for Orestis KarnezisOrestis Karnezis	Goalkeeper	Greece
Photo for Beram KayalBeram Kayal	Midfielder	Israel
Photo for Olarenwaju KayodeOlarenwaju Kayode	Forward	Nigeria
Photo for Michael KeaneMichael Keane	Defender	England
Photo for Neeskens KebanoNeeskens Kebano	Defender	The Democratic Republic Of Congo
Photo for Naby KeitaNaby Keita	Midfielder	Guinea
Photo for Caoimhin KelleherCaoimhin Kelleher	Goalkeeper	Ireland
Photo for Martin KellyMartin Kelly	Defender	England
Photo for KenedyKenedy	Midfielder	Brazil
Photo for Matthew KennedyMatthew Kennedy	Midfielder	Scotland
Photo for Jonjoe KennyJonjoe Kenny	Defender	England
Photo for Ryan KentRyan Kent	Midfielder	England
Photo for Ki Sung-yuengKi Sung-yueng	Midfielder	South Korea
Photo for Kiko FemeníaKiko Femenía	Defender	Spain
Photo for Max KilmanMax Kilman	Defender	England
Photo for Joshua KingJoshua King	Forward	Norway
Photo for Nya KirbyNya Kirby	Midfielder	England
Photo for Davy KlaassenDavy Klaassen	Midfielder	Netherlands
Photo for Ragnar KlavanRagnar Klavan	Defender	Estonia
Photo for Josh KnightJosh Knight	Defender	England
Photo for Anthony KnockaertAnthony Knockaert	Midfielder	France
Photo for Sead KolasinacSead Kolasinac	Defender	Bosnia And Herzegovina
Photo for Vincent KompanyVincent Kompany	Defender	Belgium
Photo for Terence KongoloTerence Kongolo	Defender	Netherlands
Photo for Laurent KoscielnyLaurent Koscielny	Defender	France
Photo for Cheikhou KouyatéCheikhou Kouyaté	Midfielder	Senegal
Photo for Mateo KovacicMateo Kovacic	Midfielder	Croatia
Photo for Matej KovarMatej Kovar	Goalkeeper	Czech Republic
Photo for Tim KrulTim Krul	Goalkeeper	Netherlands
Photo for Alexandre LacazetteAlexandre Lacazette	Forward	France
Photo for Adam LallanaAdam Lallana	Midfielder	England
Photo for Erik LamelaErik Lamela	Midfielder	Argentina
Photo for Manuel LanziniManuel Lanzini	Midfielder	Argentina
Photo for Aymeric LaporteAymeric Laporte	Defender	France
Photo for Jamaal LascellesJamaal Lascelles	Defender	England
Photo for Shayne LaveryShayne Lavery	Forward	Northern Ireland
Photo for Achraf LazaarAchraf Lazaar	Midfielder	Morocco
Photo for Maxime Le MarchandMaxime Le Marchand	Defender	France
Photo for Chung-Yong LeeChung-Yong Lee	Midfielder	South Korea
Photo for Adam LegzdinsAdam Legzdins	Goalkeeper	England
Photo for Florian LejeuneFlorian Lejeune	Defender	France
Photo for Mario LeminaMario Lemina	Midfielder	Gabon
Photo for Aaron LennonAaron Lennon	Midfielder	England
Photo for Bernd LenoBernd Leno	Goalkeeper	Germany
Photo for Léo BonatiniLéo Bonatini	Forward	Brazil
Photo for Jefferson LermaJefferson Lerma	Midfielder	Colombia
Photo for Thakgalo LeshabelaThakgalo Leshabela	Midfielder	South Africa
Photo for Harry LewisHarry Lewis	Goalkeeper	England
Photo for Lewis CookLewis Cook	Midfielder	England
Photo for Stephan LichtsteinerStephan Lichtsteiner	Defender	Switzerland
Photo for Anders LindegaardAnders Lindegaard	Goalkeeper	Denmark
Photo for Victor LindelöfVictor Lindelöf	Defender	Sweden
Photo for Jesse LingardJesse Lingard	Midfielder	England
Photo for Fernando LlorenteFernando Llorente	Forward	Spain
Photo for Hugo LlorisHugo Lloris	Goalkeeper	France
Photo for Jürgen LocadiaJürgen Locadia	Forward	Netherlands
Photo for Ruben Loftus-CheekRuben Loftus-Cheek	Midfielder	England
Photo for Kevin LongKevin Long	Defender	Ireland
Photo for Sean LongstaffSean Longstaff	Midfielder	England
Photo for Ademola LookmanAdemola Lookman	Forward	England
Photo for Jonas LösslJonas Lössl	Goalkeeper	Denmark
Photo for Dejan LovrenDejan Lovren	Defender	Croatia
Photo for Chris LöweChris Löwe	Defender	Germany
Photo for Matthew LowtonMatthew Lowton	Defender	England
Photo for Lucas MouraLucas Moura	Midfielder	Brazil
Photo for Lucas PerriLucas Perri	Goalkeeper	Brazil
Photo for Lucas PiazonLucas Piazon	Midfielder	Brazil
Photo for Romelu LukakuRomelu Lukaku	Forward	Belgium
Photo for Dodi LukebakioDodi Lukebakio	Forward	Belgium
Photo for Levi LumekaLevi Lumeka	Forward	England
Photo for Matt MaceyMatt Macey	Goalkeeper	England
Photo for James MaddisonJames Maddison	Midfielder	England
Photo for Gary MadineGary Madine	Forward	England
Photo for Niki MäenpääNiki Mäenpää	Goalkeeper	Finland
Photo for Pablo MaffeoPablo Maffeo	Defender	Spain
Photo for Paris MaghomaParis Maghoma	Midfielder	England
Photo for Harry MaguireHarry Maguire	Defender	England
Photo for Connor MahoneyConnor Mahoney	Midfielder	England
Photo for Riyad MahrezRiyad Mahrez	Midfielder	Algeria
Photo for Ainsley Maitland-NilesAinsley Maitland-Niles	Midfielder	England
Photo for Moses MakasiMoses Makasi	Midfielder	England
Photo for Scott MaloneScott Malone	Defender	England
Photo for Sadio ManéSadio Mané	Forward	Senegal
Photo for Eliaquim MangalaEliaquim Mangala	Defender	France
Photo for Javier ManquilloJavier Manquillo	Defender	Spain
Photo for Marc GuehiMarc Guehi	Defender	England
Photo for Adrian MariappaAdrian Mariappa	Defender	Jamaica
Photo for Lazar MarkovicLazar Markovic	Midfielder	Serbia
Photo for Dean MarneyDean Marney	Midfielder	England
Photo for George MarshGeorge Marsh	Midfielder	England
Photo for Ben MarshallBen Marshall	Midfielder	England
Photo for Anthony MartialAnthony Martial	Forward	France
Photo for Cuco MartinaCuco Martina	Defender	Curacao
Photo for Emiliano MartínezEmiliano Martínez	Goalkeeper	Argentina
Photo for Adam MasinaAdam Masina	Defender	Italy
Photo for Brandon MasonBrandon Mason	Defender	England
Photo for Ntumba MassankaNtumba Massanka	Midfielder	England
Photo for Conor MastersonConor Masterson	Defender	Ireland
Photo for Arthur MasuakuArthur Masuaku	Defender	The Democratic Republic Of Congo
Photo for Juan MataJuan Mata	Midfielder	Spain
Photo for Ales MatejuAles Mateju	Defender	Czech Republic
Photo for Nemanja MaticNemanja Matic	Midfielder	Serbia
Photo for Joel MatipJoel Matip	Defender	Cameroon
Photo for Rabbi MatondoRabbi Matondo	Forward	Wales
Photo for Matty DalyMatty Daly	Midfielder	England
Photo for Konstantinos MavropanosKonstantinos Mavropanos	Defender	Greece
Photo for Alfie MawsonAlfie Mawson	Defender	England
Photo for Chancel MbembaChancel Mbemba	Defender	The Democratic Republic Of Congo
Photo for Isaac MbenzaIsaac Mbenza	Midfielder	Belgium
Photo for James McArthurJames McArthur	Midfielder	Scotland
Photo for James McCarthyJames McCarthy	Midfielder	Ireland
Photo for Kevin McDonaldKevin McDonald	Midfielder	Scotland
Photo for George McEachranGeorge McEachran	Midfielder	England
Photo for Allan McGregorAllan McGregor	Goalkeeper	Scotland
Photo for Dwight McNeilDwight McNeil	Forward	England
Photo for Sam McQueenSam McQueen	Midfielder	England
Photo for Scott McTominayScott McTominay	Midfielder	Scotland
Photo for Zech MedleyZech Medley	Defender	England
Photo for Ben MeeBen Mee	Defender	England
Photo for Ibrahim MeiteIbrahim Meite	Forward	England
Photo for Nathaniel Mendez-LaingNathaniel Mendez-Laing	Forward	England
Photo for Nampalys MendyNampalys Mendy	Midfielder	France
Photo for Chris MephamChris Mepham	Defender	Wales
Photo for Mikel MerinoMikel Merino	Midfielder	Spain
Photo for Per MertesackerPer Mertesacker	Defender	Germany
Photo for Max MeyerMax Meyer	Midfielder	Germany
Photo for Matt MiazgaMatt Miazga	Defender	United States
Photo for Simon MignoletSimon Mignolet	Goalkeeper	Belgium
Photo for Luka MilivojevicLuka Milivojevic	Midfielder	Serbia
Photo for James MilnerJames Milner	Midfielder	England
Photo for Yerry MinaYerry Mina	Defender	Colombia
Photo for Tyrone MingsTyrone Mings	Defender	England
Photo for Kevin MirallasKevin Mirallas	Forward	Belgium
Photo for Demetri MitchellDemetri Mitchell	Defender	England
Photo for Aleksandar MitrovicAleksandar Mitrovic	Forward	Serbia
Photo for Henrikh MkhitaryanHenrikh Mkhitaryan	Midfielder	Armenia
Photo for Jan MlakarJan Mlakar	Forward	Slovenia
Photo for Mohamed ElnenyMohamed Elneny	Midfielder	Egypt
Photo for Mohamed SalahMohamed Salah	Forward	Egypt
Photo for Jayson MolumbyJayson Molumby	Midfielder	Ireland
Photo for Nacho MonrealNacho Monreal	Defender	Spain
Photo for Martín MontoyaMartín Montoya	Defender	Spain
Photo for Aaron MooyAaron Mooy	Midfielder	Australia
Photo for Álvaro MorataÁlvaro Morata	Forward	Spain
Photo for Alberto MorenoAlberto Moreno	Defender	Spain
Photo for Wes MorganWes Morgan	Defender	Jamaica
Photo for Sean MorrisonSean Morrison	Defender	England
Photo for Victor MosesVictor Moses	Midfielder	Nigeria
Photo for Steve MounieSteve Mounie	Forward	Benin
Photo for Lys MoussetLys Mousset	Forward	France
Photo for Joy MukenaJoy Mukena	Defender	England
Photo for Arijanet MuricArijanet Muric	Goalkeeper	Kosovo
Photo for Jacob MurphyJacob Murphy	Midfielder	England
Photo for Glenn MurrayGlenn Murray	Forward	England
Photo for Ahmed MusaAhmed Musa	Forward	Nigeria
Photo for Shkodran MustafiShkodran Mustafi	Defender	Germany
Photo for Jordon MutchJordon Mutch	Midfielder	England
Photo for Yoshinori MutoYoshinori Muto	Forward	Japan
Photo for Alfred N'DiayeAlfred N'Diaye	Midfielder	Senegal
Photo for Samir NasriSamir Nasri	Midfielder	France
Photo for Marc NavarroMarc Navarro	Defender	Spain
Photo for Mikael NdjoliMikael Ndjoli	Forward	England
Photo for Didier NdongDidier Ndong	Midfielder	Gabon
Photo for Layton NdukwuLayton Ndukwu	Forward	England
Photo for Reiss NelsonReiss Nelson	Forward	England
Photo for Vashon NeufvilleVashon Neufville	Defender	England
Photo for Oumar NiasseOumar Niasse	Forward	Senegal
Photo for Georges-Kévin NkoudouGeorges-Kévin Nkoudou	Midfielder	France
Photo for Lukas NmechaLukas Nmecha	Forward	Germany
Photo for Mark NobleMark Noble	Midfielder	England
Photo for Håvard NordtveitHåvard Nordtveit	Defender	Norway
Photo for Magnus NormanMagnus Norman	Goalkeeper	England
Photo for Mathias NormannMathias Normann	Midfielder	Norway
Photo for Will NorrisWill Norris	Goalkeeper	England
Photo for Oliver NorwoodOliver Norwood	Midfielder	Northern Ireland
Photo for Lewis O'BrienLewis O'Brien	Midfielder	England
Photo for Kieran O'HaraKieran O'Hara	Goalkeeper	Ireland
Photo for Stuart O'KeefeStuart O'Keefe	Midfielder	England
Photo for Aiden O'NeillAiden O'Neill	Midfielder	Australia
Photo for Matt O'RileyMatt O'Riley	Midfielder	England
Photo for Tashan Oakley-BootheTashan Oakley-Boothe	Midfielder	England
Photo for Michael ObafemiMichael Obafemi	Forward	Ireland
Photo for Pedro ObiangPedro Obiang	Midfielder	Equatorial Guinea
Photo for Denis OdoiDenis Odoi	Defender	Belgium
Photo for Nathan OfoborhNathan Ofoborh	Midfielder	Nigeria
Photo for Phil Ofosu-AyehPhil Ofosu-Ayeh	Defender	Ghana
Photo for Nathanael OgbetaNathanael Ogbeta	Defender	England
Photo for Angelo OgbonnaAngelo Ogbonna	Defender	Italy
Photo for Stefano OkakaStefano Okaka	Forward	Italy
Photo for Shinji OkazakiShinji Okazaki	Forward	Japan
Photo for Ola AinaOla Aina	Defender	Nigeria
Photo for Prince OnianguéPrince Oniangué	Midfielder	Congo
Photo for Josh OnomahJosh Onomah	Midfielder	England
Photo for Henry OnyekuruHenry Onyekuru	Forward	Nigeria
Photo for Divock OrigiDivock Origi	Forward	Belgium
Photo for Oriol RomeuOriol Romeu	Midfielder	Spain
Photo for Jordi Osei-TutuJordi Osei-Tutu	Defender	England
Photo for David OspinaDavid Ospina	Goalkeeper	Colombia
Photo for Leo OstigardLeo Ostigard	Defender	Norway
Photo for Nicolás OtamendiNicolás Otamendi	Defender	Argentina
Photo for Obbi OularéObbi Oularé	Forward	Belgium
Photo for Ovie EjariaOvie Ejaria	Midfielder	England
Photo for Reece OxfordReece Oxford	Defender	England
Photo for Alex Oxlade-ChamberlainAlex Oxlade-Chamberlain	Midfielder	England
Photo for Mesut ÖzilMesut Özil	Midfielder	Germany
Photo for Kasey PalmerKasey Palmer	Midfielder	England
Photo for Erik Palmer-BrownErik Palmer-Brown	Defender	United States
Photo for Costel PantilimonCostel Pantilimon	Goalkeeper	Romania
Photo for Mario PasalicMario Pasalic	Midfielder	Croatia
Photo for Josh PaskJosh Pask	Defender	England
Photo for Callum PatersonCallum Paterson	Defender	Scotland
Photo for Jack PayneJack Payne	Midfielder	England
Photo for PedroPedro	Forward	Spain
Photo for Lee PeltierLee Peltier	Defender	England
Photo for Adalberto PeñarandaAdalberto Peñaranda	Forward	Venezuela
Photo for Matthew PenningtonMatthew Pennington	Defender	England
Photo for Pedro PereiraPedro Pereira	Midfielder	Portugal
Photo for Roberto PereyraRoberto Pereyra	Midfielder	Argentina
Photo for Lucas PérezLucas Pérez	Forward	Spain
Photo for Nathaniel PhillipsNathaniel Phillips	Defender	England
Photo for Jordan PickfordJordan Pickford	Goalkeeper	England
Photo for Jérémy PiedJérémy Pied	Defender	France
Photo for Anthony PilkingtonAnthony Pilkington	Midfielder	Ireland
Photo for Julio PleguezueloJulio Pleguezuelo	Defender	Spain
Photo for Paul PogbaPaul Pogba	Midfielder	France
Photo for Nick PopeNick Pope	Goalkeeper	England
Photo for PotePote	Midfielder	Portugal
Photo for Ian Carlo Poveda-OcampoIan Carlo Poveda-Ocampo	Forward	England
Photo for Alex PritchardAlex Pritchard	Midfielder	England
Photo for Sebastian PrödlSebastian Prödl	Defender	Austria
Photo for Davy PröpperDavy Pröpper	Midfielder	Netherlands
Photo for Marc PughMarc Pugh	Midfielder	England
Photo for Christian PulisicChristian Pulisic	Midfielder	United States
Photo for Jason PuncheonJason Puncheon	Midfielder	England
Photo for Collin QuanerCollin Quaner	Forward	Germany
Photo for Domingos QuinaDomingos Quina	Midfielder	Portugal
Photo for Rafa MirRafa Mir	Forward	Spain
Photo for Erdal RakipErdal Rakip	Midfielder	Sweden
Photo for Joe RallsJoe Ralls	Midfielder	England
Photo for Ramadan SobhiRamadan Sobhi	Midfielder	Egypt
Photo for Sandro RamírezSandro Ramírez	Forward	Spain
Photo for Kayne RamsayKayne Ramsay	Defender	England
Photo for Aaron RamsdaleAaron Ramsdale	Goalkeeper	England
Photo for Aaron RamseyAaron Ramsey	Midfielder	Wales
Photo for Connor RandallConnor Randall	Defender	England
Photo for Marcus RashfordMarcus Rashford	Forward	England
Photo for Tim ReamTim Ream	Defender	United States
Photo for Nathan RedmondNathan Redmond	Midfielder	England
Photo for Harrison ReedHarrison Reed	Midfielder	England
Photo for Winston ReidWinston Reid	Defender	New Zealand
Photo for Jeff Reine-AdélaïdeJeff Reine-Adélaïde	Forward	France
Photo for Ricardo PereiraRicardo Pereira	Defender	Portugal
Photo for Declan RiceDeclan Rice	Defender	England
Photo for Taylor RichardsTaylor Richards	Forward	England
Photo for RicharlisonRicharlison	Forward	Brazil
Photo for Diego RicoDiego Rico	Defender	Spain
Photo for Jairo RiedewaldJairo Riedewald	Defender	Netherlands
Photo for Matt RitchieMatt Ritchie	Midfielder	Scotland
Photo for Roberto FirminoRoberto Firmino	Forward	Brazil
Photo for Patrick RobertsPatrick Roberts	Midfielder	England
Photo for Andrew RobertsonAndrew Robertson	Defender	Scotland
Photo for Joel RoblesJoel Robles	Goalkeeper	Spain
Photo for Marek RodákMarek Rodák	Goalkeeper	Slovakia
Photo for Roderick MirandaRoderick Miranda	Defender	Portugal
Photo for Marcos RojoMarcos Rojo	Defender	Argentina
Photo for Sergio RomeroSergio Romero	Goalkeeper	Argentina
Photo for Connor RonanConnor Ronan	Midfielder	Ireland
Photo for Salomón RondónSalomón Rondón	Forward	Venezuela
Photo for Danny RoseDanny Rose	Defender	England
Photo for Liam RoseniorLiam Rosenior	Defender	England
Photo for Aaron RoweAaron Rowe	Midfielder	England
Photo for Rúben NevesRúben Neves	Midfielder	Portugal
Photo for Rúben VinagreRúben Vinagre	Defender	Portugal
Photo for John RuddyJohn Ruddy	Goalkeeper	England
Photo for Antonio RüdigerAntonio Rüdiger	Defender	Germany
Photo for Rui FonteRui Fonte	Forward	Portugal
Photo for Rui PatrícioRui Patrício	Goalkeeper	Portugal
Photo for Mat RyanMat Ryan	Goalkeeper	Australia
Photo for Ryan SessegnonRyan Sessegnon	Midfielder	England
Photo for Abdelhamid SabiriAbdelhamid Sabiri	Midfielder	Germany
Photo for Romain SaïssRomain Saïss	Midfielder	Morocco
Photo for Henri SaivetHenri Saivet	Midfielder	Senegal
Photo for Bukayo SakaBukayo Saka	Forward	England
Photo for Mamadou SakhoMamadou Sakho	Defender	France
Photo for Bakary SakoBakary Sako	Midfielder	Mali
Photo for Emiliano SalaEmiliano Sala	Forward	Argentina
Photo for Martin SamuelsenMartin Samuelsen	Midfielder	Norway
Photo for Robert SánchezRobert Sánchez	Goalkeeper	Spain
Photo for Max SandersMax Sanders	Midfielder	England
Photo for Philippe SandlerPhilippe Sandler	Defender	Netherlands
Photo for Leroy SanéLeroy Sané	Forward	Germany
Photo for Santi CazorlaSanti Cazorla	Midfielder	Spain
Photo for Sean ScannellSean Scannell	Midfielder	Ireland
Photo for Fabian SchärFabian Schär	Defender	Switzerland
Photo for Ezequiel SchelottoEzequiel Schelotto	Defender	Italy
Photo for Christopher SchindlerChristopher Schindler	Defender	Germany
Photo for Jeffrey SchluppJeffrey Schlupp	Defender	Ghana
Photo for Kasper SchmeichelKasper Schmeichel	Goalkeeper	Denmark
Photo for Morgan SchneiderlinMorgan Schneiderlin	Midfielder	France
Photo for Ryan SchofieldRyan Schofield	Goalkeeper	England
Photo for André SchürrleAndré Schürrle	Midfielder	Germany
Photo for Kyle ScottKyle Scott	Midfielder	United States
Photo for Matz SelsMatz Sels	Goalkeeper	Belgium
Photo for Ken SemaKen Sema	Midfielder	Sweden
Photo for Jean Michael SeriJean Michael Seri	Midfielder	Cote D'Ivoire
Photo for Xherdan ShaqiriXherdan Shaqiri	Forward	Switzerland
Photo for Samuel Sharrock-PeplowSamuel Sharrock-Peplow	Midfielder	England
Photo for Luke ShawLuke Shaw	Defender	England
Photo for Jonjo ShelveyJonjo Shelvey	Midfielder	England
Photo for Sheyi OjoSheyi Ojo	Forward	England
Photo for Steve SidwellSteve Sidwell	Midfielder	England
Photo for Gylfi SigurdssonGylfi Sigurdsson	Midfielder	Iceland
Photo for David SilvaDavid Silva	Midfielder	Spain
Photo for Jack SimpsonJack Simpson	Defender	England
Photo for Jerome SinclairJerome Sinclair	Forward	England
Photo for Moussa SissokoMoussa Sissoko	Midfielder	France
Photo for Jiri SkalakJiri Skalak	Midfielder	Czech Republic
Photo for Oliver SkippOliver Skipp	Midfielder	England
Photo for Callum SlatteryCallum Slattery	Midfielder	England
Photo for Islam SlimaniIslam Slimani	Forward	Algeria
Photo for Chris SmallingChris Smalling	Defender	England
Photo for Brad SmithBrad Smith	Defender	Australia
Photo for Emile Smith RoweEmile Smith Rowe	Midfielder	England
Photo for Alex SmithiesAlex Smithies	Goalkeeper	England
Photo for Robert SnodgrassRobert Snodgrass	Midfielder	Scotland
Photo for SokratisSokratis	Defender	Greece
Photo for Sol BambaSol Bamba	Defender	Cote D'Ivoire
Photo for Dominic SolankeDominic Solanke	Forward	England
Photo for Solly MarchSolly March	Midfielder	England
Photo for Son Heung-MinSon Heung-Min	Forward	South Korea
Photo for Pape SouaréPape Souaré	Defender	Senegal
Photo for Çaglar SöyüncüÇaglar Söyüncü	Defender	Turkey
Photo for Julian SperoniJulian Speroni	Goalkeeper	Argentina
Photo for Junior StanislasJunior Stanislas	Midfielder	England
Photo for Jon Gorenc StankovicJon Gorenc Stankovic	Defender	Slovenia
Photo for Jason SteeleJason Steele	Goalkeeper	England
Photo for Maarten StekelenburgMaarten Stekelenburg	Goalkeeper	Netherlands
Photo for Dale StephensDale Stephens	Midfielder	England
Photo for Dujon SterlingDujon Sterling	Defender	England
Photo for Jamie SterryJamie Sterry	Defender	England
Photo for Steve CookSteve Cook	Defender	England
Photo for Steven SessegnonSteven Sessegnon	Midfielder	England
Photo for Ben StevensonBen Stevenson	Midfielder	England
Photo for Carl StewartCarl Stewart	Midfielder	England
Photo for John StonesJohn Stones	Defender	England
Photo for Stuart TaylorStuart Taylor	Goalkeeper	England
Photo for Daniel SturridgeDaniel Sturridge	Forward	England
Photo for Andrew SurmanAndrew Surman	Midfielder	England
Photo for Sam SurridgeSam Surridge	Forward	England
Photo for Markus SuttnerMarkus Suttner	Defender	Austria
Photo for Alexander SørlothAlexander Sørloth	Forward	Norway
Photo for Dusan TadicDusan Tadic	Forward	Serbia
Photo for Japhet TangangaJaphet Tanganga	Defender	England
Photo for Shani TarashajShani Tarashaj	Forward	Switzerland
Photo for Matt TargettMatt Targett	Defender	England
Photo for James TarkowskiJames Tarkowski	Defender	England
Photo for Percy TauPercy Tau	Forward	South Africa
Photo for Nikola TavaresNikola Tavares	Defender	England
Photo for Kyle TaylorKyle Taylor	Midfielder	England
Photo for Tayo EdunTayo Edun	Midfielder	England
Photo for George ThomasGeorge Thomas	Forward	Wales
Photo for Jared ThompsonJared Thompson	Goalkeeper	England
Photo for Jon Dagur ThorsteinssonJon Dagur Thorsteinsson	Midfielder	Iceland
Photo for Youri TielemansYouri Tielemans	Midfielder	Belgium
Photo for James TilleyJames Tilley	Forward	England
Photo for Tom Dele-BashiruTom Dele-Bashiru	Midfielder	England
Photo for James TomkinsJames Tomkins	Defender	England
Photo for Lee TomlinLee Tomlin	Forward	England
Photo for Fikayo TomoriFikayo Tomori	Defender	England
Photo for Toni MartínezToni Martínez	Forward	Spain
Photo for Lucas TorreiraLucas Torreira	Midfielder	Uruguay
Photo for Tosin AdarabioyoTosin Adarabioyo	Defender	England
Photo for Cenk TosunCenk Tosun	Forward	Turkey
Photo for Yaya TouréYaya Touré	Midfielder	Cote D'Ivoire
Photo for Richard TowellRichard Towell	Midfielder	Ireland
Photo for Andros TownsendAndros Townsend	Midfielder	England
Photo for Shilow TraceyShilow Tracey	Midfielder	England
Photo for Armand TraoreArmand Traore	Defender	Senegal
Photo for Mark TraversMark Travers	Goalkeeper	Ireland
Photo for Kieran TrippierKieran Trippier	Defender	England
Photo for Nathan TrottNathan Trott	Goalkeeper	England
Photo for Axel TuanzebeAxel Tuanzebe	Defender	England
Photo for Joe TupperJoe Tupper	Goalkeeper	England
Photo for Leonardo UlloaLeonardo Ulloa	Forward	Argentina
Photo for Yan ValeryYan Valery	Defender	France
Photo for Patrick van AanholtPatrick van Aanholt	Defender	Netherlands
Photo for Virgil van DijkVirgil van Dijk	Defender	Netherlands
Photo for Rajiv van La ParraRajiv van La Parra	Midfielder	Netherlands
Photo for Jamie VardyJamie Vardy	Forward	England
Photo for Jan VertonghenJan Vertonghen	Defender	Belgium
Photo for Jannik VestergaardJannik Vestergaard	Defender	Denmark
Photo for Luciano ViettoLuciano Vietto	Forward	Argentina
Photo for Nikola VlasicNikola Vlasic	Midfielder	Croatia
Photo for Sam VokesSam Vokes	Forward	Wales
Photo for Michel VormMichel Vorm	Goalkeeper	Netherlands
Photo for Matej VydraMatej Vydra	Forward	Czech Republic
Photo for Theo WalcottTheo Walcott	Forward	England
Photo for Kyle WalkerKyle Walker	Defender	England
Photo for Kyle Walker-PetersKyle Walker-Peters	Defender	England
Photo for Anton WalkesAnton Walkes	Defender	England
Photo for Jonathan WaltersJonathan Walters	Forward	Ireland
Photo for Aaron Wan-BissakaAaron Wan-Bissaka	Midfielder	England
Photo for Victor WanyamaVictor Wanyama	Midfielder	Kenya
Photo for Stephen WardStephen Ward	Defender	Ireland
Photo for James Ward-ProwseJames Ward-Prowse	Midfielder	England
Photo for Elliot WattElliot Watt	Midfielder	Scotland
Photo for Kelland WattsKelland Watts	Midfielder	England
Photo for Danny WelbeckDanny Welbeck	Forward	England
Photo for Nahki WellsNahki Wells	Forward	Bermuda
Photo for Ashley WestwoodAshley Westwood	Midfielder	England
Photo for Ben WhiteBen White	Defender	England
Photo for Dean WhiteheadDean Whitehead	Midfielder	England
Photo for Alfie WhitemanAlfie Whiteman	Goalkeeper	England
Photo for Ben WhitfieldBen Whitfield	Midfielder	England
Photo for Connor WickhamConnor Wickham	Forward	England
Photo for Rhoys WigginsRhoys Wiggins	Defender	Wales
Photo for Georginio WijnaldumGeorginio Wijnaldum	Midfielder	Netherlands
Photo for Yanic WildschutYanic Wildschut	Forward	Netherlands
Photo for Wilfred NdidiWilfred Ndidi	Midfielder	Nigeria
Photo for Ashley WilliamsAshley Williams	Defender	Wales
Photo for WillianWillian	Forward	Brazil
Photo for Ben WilmotBen Wilmot	Defender	England
Photo for Jack WilshereJack Wilshere	Midfielder	England
Photo for Callum WilsonCallum Wilson	Forward	England
Photo for Harry WinksHarry Winks	Midfielder	England
Photo for Chris WoodChris Wood	Forward	New Zealand
Photo for Ben WoodburnBen Woodburn	Forward	Wales
Photo for Cauley WoodrowCauley Woodrow	Forward	England
Photo for Sam WoodsSam Woods	Defender	England
Photo for Xande SilvaXande Silva	Forward	Portugal
Photo for Granit XhakaGranit Xhaka	Midfielder	Switzerland
Photo for Andriy YarmolenkoAndriy Yarmolenko	Forward	Ukraine
Photo for DeAndre YedlinDeAndre Yedlin	Defender	United States
Photo for Maya YoshidaMaya Yoshida	Defender	Japan
Photo for Ashley YoungAshley Young	Defender	England
Photo for Pablo ZabaletaPablo Zabaleta	Defender	Argentina
Photo for Wilfried ZahaWilfried Zaha	Forward	Cote D'Ivoire
Photo for André-Frank Zambo AnguissaAndré-Frank Zambo Anguissa	Midfielder	Cameroon
Photo for ZankaZanka	Defender	Denmark
Photo for Davide ZappacostaDavide Zappacosta	Defender	Italy
Photo for Mauro ZárateMauro Zárate	Forward	Argentina
Photo for Marvin ZeegelaarMarvin Zeegelaar	Defender	Netherlands
Photo for Oleksandr ZinchenkoOleksandr Zinchenko	Midfielder	Ukraine
Photo for Kenneth ZohoreKenneth Zohore	Forward	Denmark
Photo for Nabili Zoubdi TouaiziNabili Zoubdi Touaizi	Forward	Spain
Photo for Kurt ZoumaKurt Zouma	Defender	France
Photo for Michal ZyroMichal Zyro	Forward	Poland
